The Mars Volta - Frances the Mute
Jethro Tull - Thick as a Brick
Animal Collective - Strawberry Jam
Unexpect - Fables of the Sleepless Empire
Melt-Banana - Fetch
Sleepytime Gorilla Museum - Of Natural History
Ulver - Perdition City
Fishmans - Long Season
Kashiwa Daisuke - Program Music I
Death Grips - The Powers that B
Mr. Bungle - California
Boredoms - Vision Creation Newsun
Swans - To Be Kind
Diablo Swing Orchestra - Pandora's Piñata
Neutral Milk Hotel - In the Aeroplane Over the Sea
David Bowie - Blackstar
Comus - First Utterance
Bent Knee - Shiny Eyed Babies
Gevende - Sen Balik Degilsin ki
Shinning - Blackjazz
King Crimson - In the Court of the Crimson King
Darren Korb - Transistor Original Soundtrack
So Hideous - Laurestine
Charles Mingus - Mingus Ah Um
The Dilinger Escape Plan - One of Us is the Killer
Aesop Rock - The Impossible Kid
Bjork - Homogenic
Refused - The Shape of Punk to Come
Ryoji Ikeda - Dataplex
Nils Frahm - Spaces
Steve Reich - Phases
Future of the Left - How to Stop Your Brain in an Accident
Gazpacho - Demon
Vampillia - my beautiful twisted nightmares in aurora rainbow darkness
clipping. - Splendor & Misery
Igorrr - Hallelujah
Rabbit Rabbit - Rabbit Tabbit Radio, Vol. 1
Kairon; IRSE! - Ujubasajuba
Obscure Sphinx - Void Mother
Jeremy Flower - The Real Me
Yes - Close to the Edge
Sufjan Stevens - The Age of Adz
Opeth - Ghost Reveries
Janelle Monae - The ArchAndroid
World's End Girlfriend - LAST WALTZ
Boris - Pink
Sikth - The Trees are Dead & Dried Out Wait for Something Wild
Talk Talk - Laughing Stock
Jon Hopkins - Immunity
Max Richter - Recomposed by Max Richter: Vivaldi, The Four Seasons
Earth - The Bees Made Honey in the Lion's Skull
Daft Punk - Discovery
Tool - 10,00 Days
Fallujah - Dreamless
Andrew Jackson Jihad - People that Can Eat People are the Luckiest People in the World
Sheena Ringo - Kalk Samen Kuri no Hana
Metá Metá - MM3
Ben Levin Group - Freak Machine
Clarence Clarity - No Now
Radiohead - Kid A
Godspeed You! Black Emperor - 'Allelujah! Don't Bend! Ascend!
Kendrick Lamar - To Pimp a Butterfly
Anathema - Weather Systems
Natural Snow Buildings - The Dance of the Moon and the Sun
Lazer/Wulf - The Beast of Left and Right
Sigur Rós - Agaetis Byrjun
BADBADNOTGOOD - BBNG2	
No Bird Sing - Definition Sickness
Midori - Aratamemashite, hajimemashite, Midori desu.
Fumie Kutamani - Planetary Pieces: Sonic World Adventure Original Soundtrack
Rishloo - Feathergun
OMB - SwineSong
Ayreon - The Human Equation
Fire! Orchestra - Enter
Nujabes - Metaphorical Music
Meshuggah - Catch ThirtyThree
Fiona Apple - The Idler Wheel...
The Dear Hunter - The Color Spectrum The Complete Collection
Odonis Odonis - Hard Boiled Soft Boiled
Envy - Atheist's Cornea
Chelsea Wolfe - Abyss
System of a Down - Steal this Album!
Algiers - Algier
The Visit - Through Darkness into Light
Marketa Irglova - Muna
Lunatic Soul - Walking on a Flashlight Beam
Muse - Origin of Symmetry
King Gizzard & The Lizard Wizard - Nonagon Infinity
Dream Theater - Six Degrees of Inner Turbulence
Cynic - Traced in Air
Rage Against the Machine - Rage Against the Machine
Devin Townsend Project - Deconstruction
Madvillain - Madvillainy
Alter Bridge - Fortress
Girl Band - Holding Hands with Jamie
tUnE-yArDs - w h o k i l l
OOIOO - TAIGA
Queen - Innuendo
Sigh - In Somniphobia
Jenny Hval & Susanna - Meshes of Voice