Dream Theater - Octavarium
Opeth - Ghost Reveries
Leprous - Bilateral
Mr. Bungle - California
maudlin of the well - bath
Radiohead - OK Computer
Godspeed You! Black Emperor - F# A# Infinity
David Bowie - Blackstar
Haken - The Mountain
Slice the Cake - Oddyssey to the West
Kayo Dot - Hubardo
The Dear Hunter - Act V: Hymns With the Devil in Confessional
Porcupine Tree - Fear of a Blank Planet
We Lost the Sea - Departure Songs
Between the Buried and Me - Colors
Steven Wilson - The Raven That Refused To Sing (and Other Stories)
Mastodon - Crack The Skye
Agalloch - The Mantle
Shinning - Blackjazz
Riverside - Love, Fear and the Time Machine
Giant Squid - The Ichthyologist
King Crimson - Red
Unexpect - Fables of the Sleepless Empire
Persefone - Spiritual Migration
Ulver - Perdition City
Converge - Jane Doe
The Red Paintings - The Revolution Is Never Coming
Anathema - Weather Systems
Vektor - Terminal Redux
Cult of Luna - Mariner
TesseracT - Altered State
The Mars Volta - Frances The Mute
Silver Mt. Zion - He Has Left Us Alone...
Giles Corey - Giles Corey
Katatonia - The Great Cold Distance
Alter Bridge - Blackbird
Pink Floyd - Animals
Batushka - Litourgiya
Behemoth - The Satanist
Bohren & der Club of Gore - Bohren For Beginners
Spectral Lore - III
Schammasch - Triangle
Gorguts - Colored Sands
Closure in Moscow - Pink Lemonade
Thank You Scientist - Stranger Heads Prevail
Chelsea Wolfe - Abyss
Have a Nice Life - Deathconsciousness
Woods of Ypres - Woods 5: Grey Skies & Electric Light
A Forest of Stars - Beware the Sword You Cannot See
Hail Spirit Noir - Oi Magoi
Deathspell Omega - Paracletus
Sigh - Imaginary Sonicscape
Blue-Eyed Hawk - Under the Moon
Obscure Sphinx - Void Mother
Dreadnought - Bridging Realms
Oathbreaker - Rheia
So Hideous - Laurestine
Car Bomb - Meta
Down I Go - You're Lucky God, That I Cannot Reach You
Tiamat - Wildhoney
The Armed - Untitled
Ihsahn - Arktis.
First Fragment - Dasein
The Body - No One Deserves Happiness
Native Construct - Quiet World
Follow the White Rabbit - Endorphinia
Plebeian Grandstand - Lowgazers
Rishloo - Living As Ghosts With Buildings As Teeth
Gazpacho - Demon
Lunatic Soul - Walking on a Flashlight Beam
Sleepytime Gorilla Museum - Of Natural History
The Dillinger Escape Plan - Dissociation
Sigur Rós - Agaetis Byrjun
Orphaned Land - The Never Ending Way of ORwarriOR
Muse - Black Holes and Revelations
OSI - Blood
Ólafur arnalds - ...and they have escaped the weight of darkness
Nils Frahlm - solo
Nine Inch Nails - The Downward Spiral
Ancestors - In Dreams and Time
Black Math Horseman - Wyllt
The Angelic Process - Weighing Souls With Sand
Om - Advaitic Songs
clipping. - CLPPNG
Kendrick Lamar - To Pimp A Butterfly
Flying Lotus - Cosmogramma
Ayreon - The Human Equation
Fall of Efrafa - The Warren Of Snares Trilogy
Comus - First Utterance
Ghost Bath - Moonlover
Epheul Duath - The Painter's Palette
David Maxim Micic - ECO
ISIS - Oceanic
Green Carnation - Light of Day, Day Of Darkness
Tigram Hamasyan - Mockroot
Kaitylyn Aurelia Smith - EARS
Subterranean Masquerade - The Great Bazaar
Xanthochroid - Blessed He With Boils
Soen - Tellurian
Ne Obliviscaris - Citadel
